Aacgr	Î†
aacgr	Î¬
Aacute	Ã
aacute	Ã¡
Abreve	Ä‚
abreve	Äƒ
ac	âˆ¾
acd	âˆ¿
acE	âˆ¾Ì³
Acirc	Ã‚
acirc	Ã¢
acute	Â´
Acy	Ğ
acy	Ğ°
AElig	Ã†
aelig	Ã¦
af	â¡
Afr	ğ”„
afr	ğ”
Agr	Î‘
agr	Î±
Agrave	Ã€
agrave	Ã 
alefsym	â„µ
aleph	â„µ
Alpha	Î‘
alpha	Î±
Amacr	Ä€
amacr	Ä
amalg	â¨¿
amp	&
and	âˆ§
And	â©“
andand	â©•
andd	â©œ
andslope	â©˜
andv	â©š
ang	âˆ 
ange	â¦¤
angle	âˆ 
angmsd	âˆ¡
angmsdaa	â¦¨
angmsdab	â¦©
angmsdac	â¦ª
angmsdad	â¦«
angmsdae	â¦¬
angmsdaf	â¦­
angmsdag	â¦®
angmsdah	â¦¯
angrt	âˆŸ
angrtvb	âŠ¾
angrtvbd	â¦
angsph	âˆ¢
angst	â„«
angzarr	â¼
Aogon	Ä„
aogon	Ä…
Aopf	ğ”¸
aopf	ğ•’
ap	â‰ˆ
apacir	â©¯
ape	â‰Š
apE	â©°
apid	â‰‹
apos	'
ApplyFunction	â¡
approx	â‰ˆ
approxeq	â‰Š
Aring	Ã…
aring	Ã¥
Ascr	ğ’œ
ascr	ğ’¶
Assign	â‰”
ast	*
asymp	â‰ˆ
asympeq	â‰
Atilde	Ãƒ
atilde	Ã£
Auml	Ã„
auml	Ã¤
awconint	âˆ³
awint	â¨‘
backcong	â‰Œ
backepsilon	Ï¶
backprime	â€µ
backsim	âˆ½
backsimeq	â‹
Backslash	âˆ–
Barv	â«§
barvee	âŠ½
barwed	âŒ…
Barwed	âŒ†
barwedge	âŒ…
bbrk	âµ
bbrktbrk	â¶
bcong	â‰Œ
Bcy	Ğ‘
bcy	Ğ±
bdquo	â€
becaus	âˆµ
because	âˆµ
bemptyv	â¦°
bepsi	Ï¶
bernou	â„¬
Bernoullis	â„¬
Beta	Î’
beta	Î²
beth	â„¶
between	â‰¬
Bfr	ğ”…
bfr	ğ”Ÿ
Bgr	Î’
bgr	Î²
bigcap	â‹‚
bigcirc	â—¯
bigcup	â‹ƒ
bigodot	â¨€
bigoplus	â¨
bigotimes	â¨‚
bigsqcup	â¨†
bigstar	â˜…
bigtriangledown	â–½
bigtriangleup	â–³
biguplus	â¨„
bigvee	â‹
bigwedge	â‹€
bkarow	â¤
blacklozenge	â§«
blacksquare	â–ª
blacktriangle	â–´
blacktriangledown	â–¾
blacktriangleleft	â—‚
blacktriangleright	â–¸
blank	â£
blk12	â–’
blk14	â–‘
blk34	â–“
block	â–ˆ
bne	=âƒ¥
bnequiv	â‰¡âƒ¥
bnot	âŒ
bNot	â«­
Bopf	ğ”¹
bopf	ğ•“
bot	âŠ¥
bottom	âŠ¥
bowtie	â‹ˆ
boxbox	â§‰
boxdl	â”
boxdL	â••
boxDl	â•–
boxDL	â•—
boxdr	â”Œ
boxdR	â•’
boxDr	â•“
boxDR	â•”
boxh	â”€
boxH	â•
boxhd	â”¬
boxHd	â•¤
boxhD	â•¥
boxHD	â•¦
boxhu	â”´
boxHu	â•§
boxhU	â•¨
boxHU	â•©
boxminus	âŠŸ
boxplus	âŠ
boxtimes	âŠ 
boxul	â”˜
boxuL	â•›
boxUl	â•œ
boxUL	â•
boxur	â””
boxuR	â•˜
boxUr	â•™
boxUR	â•š
boxv	â”‚
boxV	â•‘
boxvh	â”¼
boxvH	â•ª
boxVh	â•«
boxVH	â•¬
boxvl	â”¤
boxvL	â•¡
boxVl	â•¢
boxVL	â•£
boxvr	â”œ
boxvR	â•
boxVr	â•Ÿ
boxVR	â• 
bprime	â€µ
breve	Ë˜
brvbar	Â¦
Bscr	â„¬
bscr	ğ’·
bsemi	â
bsim	âˆ½
bsime	â‹
bsol	\
bsolb	â§…
bsolhsub	\âŠ‚
bull	â€¢
bullet	â€¢
bump	â‰
bumpe	â‰
bumpE	âª®
Bumpeq	â‰
bumpeq	â‰
Cacute	Ä†
cacute	Ä‡
cap	âˆ©
Cap	â‹’
capand	â©„
capbrcup	â©‰
capcap	â©‹
capcup	â©‡
capdot	â©€
CapitalDifferentialD	â……
caps	âˆ©ï¸€
caret	â
caron	Ë‡
Cayleys	â„­
ccaps	â©
Ccaron	ÄŒ
ccaron	Ä
Ccedil	Ã‡
ccedil	Ã§
Ccirc	Äˆ
ccirc	Ä‰
Cconint	âˆ°
ccups	â©Œ
ccupssm	â©
Cdot	ÄŠ
cdot	Ä‹
cedil	Â¸
Cedilla	Â¸
cemptyv	â¦²
cent	Â¢
centerdot	Â·
Cfr	â„­
cfr	ğ” 
CHcy	Ğ§
chcy	Ñ‡
check	âœ“
checkmark	âœ“
Chi	Î§
chi	Ï‡
cir	â—‹
circ	Ë†
circeq	â‰—
circlearrowleft	â†º
circlearrowright	â†»
circledast	âŠ›
circledcirc	âŠš
circleddash	âŠ
CircleDot	âŠ™
circledR	Â®
circledS	â“ˆ
CircleMinus	âŠ–
CirclePlus	âŠ•
CircleTimes	âŠ—
cire	â‰—
cirE	â§ƒ
cirfnint	â¨
cirmid	â«¯
cirscir	â§‚
ClockwiseContourIntegral	âˆ²
CloseCurlyDoubleQuote	â€
CloseCurlyQuote	â€™
clubs	â™£
clubsuit	â™£
colon	:
Colon	âˆ·
colone	â‰”
Colone	â©´
coloneq	â‰”
comma	,
commat	@
comp	âˆ
compfn	âˆ˜
complement	âˆ
complexes	â„‚
cong	â‰…
congdot	â©­
Congruent	â‰¡
conint	âˆ®
Conint	âˆ¯
ContourIntegral	âˆ®
Copf	â„‚
copf	ğ•”
coprod	âˆ
Coproduct	âˆ
copy	Â©
copysr	â„—
CounterClockwiseContourIntegral	âˆ³
crarr	â†µ
cross	âœ—
Cross	â¨¯
Cscr	ğ’
cscr	ğ’¸
csub	â«
csube	â«‘
csup	â«
csupe	â«’
ctdot	â‹¯
cudarrl	â¤¸
cudarrr	â¤µ
cuepr	â‹
cuesc	â‹Ÿ
cularr	â†¶
cularrp	â¤½
cup	âˆª
Cup	â‹“
cupbrcap	â©ˆ
CupCap	â‰
cupcap	â©†
cupcup	â©Š
cupdot	âŠ
cupor	â©…
cups	âˆªï¸€
curarr	â†·
curarrm	â¤¼
curlyeqprec	â‹
curlyeqsucc	â‹Ÿ
curlyvee	â‹
curlywedge	â‹
curren	Â¤
curvearrowleft	â†¶
curvearrowright	â†·
cuvee	â‹
cuwed	â‹
cwconint	âˆ²
cwint	âˆ±
cylcty	âŒ­
dagger	â€ 
Dagger	â€¡
daleth	â„¸
darr	â†“
Darr	â†¡
dArr	â‡“
dash	â€
dashv	âŠ£
Dashv	â«¤
dbkarow	â¤
dblac	Ë
Dcaron	Ä
dcaron	Ä
Dcy	Ğ”
dcy	Ğ´
DD	â……
dd	â…†
ddagger	â€¡
ddarr	â‡Š
DDotrahd	â¤‘
ddotseq	â©·
deg	Â°
Del	âˆ‡
Delta	Î”
delta	Î´
demptyv	â¦±
dfisht	â¥¿
Dfr	ğ”‡
dfr	ğ”¡
Dgr	Î”
dgr	Î´
dHar	â¥¥
dharl	â‡ƒ
dharr	â‡‚
DiacriticalAcute	Â´
DiacriticalDot	Ë™
DiacriticalDoubleAcute	Ë
DiacriticalGrave	`
DiacriticalTilde	Ëœ
diam	â‹„
diamond	â‹„
diamondsuit	â™¦
diams	â™¦
die	Â¨
DifferentialD	â…†
digamma	Ï
disin	â‹²
div	Ã·
divide	Ã·
divideontimes	â‹‡
divonx	â‹‡
DJcy	Ğ‚
djcy	Ñ’
dlcorn	âŒ
dlcrop	âŒ
dollar	$
Dopf	ğ”»
dopf	ğ••
Dot	Â¨
dot	Ë™
DotDot	 âƒœ
doteq	â‰
doteqdot	â‰‘
DotEqual	â‰
dotminus	âˆ¸
dotplus	âˆ”
dotsquare	âŠ¡
doublebarwedge	âŒ†
DoubleContourIntegral	âˆ¯
DoubleDot	Â¨
DoubleDownArrow	â‡“
DoubleLeftArrow	â‡
DoubleLeftRightArrow	â‡”
DoubleLeftTee	â«¤
DoubleLongLeftArrow	âŸ¸
DoubleLongLeftRightArrow	âŸº
DoubleLongRightArrow	âŸ¹
DoubleRightArrow	â‡’
DoubleRightTee	âŠ¨
DoubleUpArrow	â‡‘
DoubleUpDownArrow	â‡•
DoubleVerticalBar	âˆ¥
downarrow	â†“
Downarrow	â‡“
DownArrowBar	â¤“
DownArrowUpArrow	â‡µ
DownBreve	 Ì‘
downdownarrows	â‡Š
downharpoonleft	â‡ƒ
downharpoonright	â‡‚
DownLeftRightVector	â¥
DownLeftTeeVector	â¥
DownLeftVector	â†½
DownLeftVectorBar	â¥–
DownRightTeeVector	â¥Ÿ
DownRightVector	â‡
DownRightVectorBar	â¥—
DownTee	âŠ¤
DownTeeArrow	â†§
drbkarow	â¤
drcorn	âŒŸ
drcrop	âŒŒ
Dscr	ğ’Ÿ
dscr	ğ’¹
DScy	Ğ…
dscy	Ñ•
dsol	â§¶
Dstrok	Ä
dstrok	Ä‘
dtdot	â‹±
dtri	â–¿
dtrif	â–¾
duarr	â‡µ
duhar	â¥¯
dwangle	â¦¦
DZcy	Ğ
dzcy	ÑŸ
dzigrarr	âŸ¿
Eacgr	Îˆ
eacgr	Î­
Eacute	Ã‰
eacute	Ã©
easter	â©®
Ecaron	Äš
ecaron	Ä›
ecir	â‰–
Ecirc	ÃŠ
ecirc	Ãª
ecolon	â‰•
Ecy	Ğ­
ecy	Ñ
eDDot	â©·
Edot	Ä–
edot	Ä—
eDot	â‰‘
ee	â…‡
EEacgr	Î‰
eeacgr	Î®
EEgr	Î—
eegr	Î·
efDot	â‰’
Efr	ğ”ˆ
efr	ğ”¢
eg	âªš
Egr	Î•
egr	Îµ
Egrave	Ãˆ
egrave	Ã¨
egs	âª–
egsdot	âª˜
el	âª™
Element	âˆˆ
elinters	â§
ell	â„“
els	âª•
elsdot	âª—
Emacr	Ä’
emacr	Ä“
empty	âˆ…
emptyset	âˆ…
EmptySmallSquare	â—»
emptyv	âˆ…
EmptyVerySmallSquare	â–«
emsp	â€ƒ
emsp13	â€„
emsp14	â€…
ENG	ÅŠ
eng	Å‹
ensp	â€‚
Eogon	Ä˜
eogon	Ä™
Eopf	ğ”¼
eopf	ğ•–
epar	â‹•
eparsl	â§£
eplus	â©±
epsi	Ïµ
Epsilon	Î•
epsilon	Îµ
epsiv	Îµ
eqcirc	â‰–
eqcolon	â‰•
eqsim	â‰‚
eqslantgtr	âª–
eqslantless	âª•
Equal	â©µ
equals	=
EqualTilde	â‰‚
equest	â‰Ÿ
Equilibrium	â‡Œ
equiv	â‰¡
equivDD	â©¸
eqvparsl	â§¥
erarr	â¥±
erDot	â‰“
escr	â„¯
Escr	â„°
esdot	â‰
esim	â‰‚
Esim	â©³
Eta	Î—
eta	Î·
ETH	Ã
eth	Ã°
Euml	Ã‹
euml	Ã«
euro	â‚¬
excl	!
exist	âˆƒ
Exists	âˆƒ
expectation	â„°
exponentiale	â…‡
fallingdotseq	â‰’
Fcy	Ğ¤
fcy	Ñ„
female	â™€
ffilig	ï¬ƒ
fflig	ï¬€
ffllig	ï¬„
Ffr	ğ”‰
ffr	ğ”£
filig	ï¬
FilledSmallSquare	â—¼
FilledVerySmallSquare	â–ª
fjlig	fj
flat	â™­
fllig	ï¬‚
fltns	â–±
fnof	Æ’
Fopf	ğ”½
fopf	ğ•—
forall	âˆ€
fork	â‹”
forkv	â«™
Fouriertrf	â„±
fpartint	â¨
frac12	Â½
frac13	â…“
frac14	Â¼
frac15	â…•
frac16	â…™
frac18	â…›
frac23	â…”
frac25	â…–
frac34	Â¾
frac35	â…—
frac38	â…œ
frac45	â…˜
frac56	â…š
frac58	â…
frac78	â…
frasl	â„
frown	âŒ¢
Fscr	â„±
fscr	ğ’»
gacute	Çµ
Gamma	Î“
gamma	Î³
Gammad	Ïœ
gammad	Ï
gap	âª†
Gbreve	Ä
gbreve	ÄŸ
Gcedil	Ä¢
Gcirc	Äœ
gcirc	Ä
Gcy	Ğ“
gcy	Ğ³
Gdot	Ä 
gdot	Ä¡
ge	â‰¥
gE	â‰§
gel	â‹›
gEl	âªŒ
geq	â‰¥
geqq	â‰§
geqslant	â©¾
ges	â©¾
gescc	âª©
gesdot	âª€
gesdoto	âª‚
gesdotol	âª„
gesl	â‹›ï¸€
gesles	âª”
Gfr	ğ”Š
gfr	ğ”¤
gg	â‰«
Gg	â‹™
ggg	â‹™
Ggr	Î“
ggr	Î³
gimel	â„·
GJcy	Ğƒ
gjcy	Ñ“
gl	â‰·
gla	âª¥
glE	âª’
glj	âª¤
gnap	âªŠ
gnapprox	âªŠ
gnE	â‰©
gne	âªˆ
gneq	âªˆ
gneqq	â‰©
gnsim	â‹§
Gopf	ğ”¾
gopf	ğ•˜
grave	`
GreaterEqual	â‰¥
GreaterEqualLess	â‹›
GreaterFullEqual	â‰§
GreaterGreater	âª¢
GreaterLess	â‰·
GreaterSlantEqual	â©¾
GreaterTilde	â‰³
gscr	â„Š
Gscr	ğ’¢
gsim	â‰³
gsime	âª
gsiml	âª
gt	>
Gt	â‰«
gtcc	âª§
gtcir	â©º
gtdot	â‹—
gtlPar	â¦•
gtquest	â©¼
gtrapprox	âª†
gtrarr	â¥¸
gtrdot	â‹—
gtreqless	â‹›
gtreqqless	âªŒ
gtrless	â‰·
gtrsim	â‰³
gvertneqq	â‰©ï¸€
gvnE	â‰©ï¸€
Hacek	Ë‡
hairsp	â€Š
half	Â½
hamilt	â„‹
HARDcy	Ğª
hardcy	ÑŠ
harr	â†”
hArr	â‡”
harrcir	â¥ˆ
harrw	â†­
Hat	^
hbar	â„
Hcirc	Ä¤
hcirc	Ä¥
hearts	â™¥
heartsuit	â™¥
hellip	â€¦
hercon	âŠ¹
Hfr	â„Œ
hfr	ğ”¥
HilbertSpace	â„‹
hksearow	â¤¥
hkswarow	â¤¦
hoarr	â‡¿
homtht	âˆ»
hookleftarrow	â†©
hookrightarrow	â†ª
Hopf	â„
hopf	ğ•™
horbar	â€•
HorizontalLine	â”€
Hscr	â„‹
hscr	ğ’½
hslash	â„
Hstrok	Ä¦
hstrok	Ä§
HumpDownHump	â‰
HumpEqual	â‰
hybull	âƒ
hyphen	â€
Iacgr	ÎŠ
iacgr	Î¯
Iacute	Ã
iacute	Ã­
ic	â£
Icirc	Ã
icirc	Ã®
Icy	Ğ˜
icy	Ğ¸
idiagr	Î
Idigr	Îª
idigr	ÏŠ
Idot	Ä°
IEcy	Ğ•
iecy	Ğµ
iexcl	Â¡
iff	â‡”
Ifr	â„‘
ifr	ğ”¦
Igr	Î™
igr	Î¹
Igrave	ÃŒ
igrave	Ã¬
ii	â…ˆ
iiiint	â¨Œ
iiint	âˆ­
iinfin	â§œ
iiota	â„©
IJlig	Ä²
ijlig	Ä³
Im	â„‘
Imacr	Äª
imacr	Ä«
image	â„‘
ImaginaryI	â…ˆ
imagline	â„
imagpart	â„‘
imath	Ä±
imof	âŠ·
imped	Æµ
Implies	â‡’
in	âˆˆ
incare	â„…
infin	âˆ
infintie	â§
inodot	Ä±
int	âˆ«
Int	âˆ¬
intcal	âŠº
integers	â„¤
Integral	âˆ«
intercal	âŠº
Intersection	â‹‚
intlarhk	â¨—
intprod	â¨¼
InvisibleComma	â£
InvisibleTimes	â¢
IOcy	Ğ
iocy	Ñ‘
Iogon	Ä®
iogon	Ä¯
Iopf	ğ•€
iopf	ğ•š
Iota	Î™
iota	Î¹
iprod	â¨¼
iquest	Â¿
Iscr	â„
iscr	ğ’¾
isin	âˆˆ
isindot	â‹µ
isinE	â‹¹
isins	â‹´
isinsv	â‹³
isinv	âˆˆ
it	â¢
Itilde	Ä¨
itilde	Ä©
Iukcy	Ğ†
iukcy	Ñ–
Iuml	Ã
iuml	Ã¯
Jcirc	Ä´
jcirc	Äµ
Jcy	Ğ™
jcy	Ğ¹
Jfr	ğ”
jfr	ğ”§
jmath	È·
Jopf	ğ•
jopf	ğ•›
Jscr	ğ’¥
jscr	ğ’¿
Jsercy	Ğˆ
jsercy	Ñ˜
Jukcy	Ğ„
jukcy	Ñ”
Kappa	Îš
kappa	Îº
kappav	Ï°
Kcedil	Ä¶
kcedil	Ä·
Kcy	Ğš
kcy	Ğº
Kfr	ğ”
kfr	ğ”¨
Kgr	Îš
kgr	Îº
kgreen	Ä¸
KHcy	Ğ¥
khcy	Ñ…
KHgr	Î§
khgr	Ï‡
KJcy	ĞŒ
kjcy	Ñœ
Kopf	ğ•‚
kopf	ğ•œ
Kscr	ğ’¦
kscr	ğ“€
lAarr	â‡š
Lacute	Ä¹
lacute	Äº
laemptyv	â¦´
lagran	â„’
Lambda	Î›
lambda	Î»
lang	âŸ¨
Lang	âŸª
langd	â¦‘
langle	âŸ¨
lap	âª…
Laplacetrf	â„’
laquo	Â«
larr	â†
Larr	â†
lArr	â‡
larrb	â‡¤
larrbfs	â¤Ÿ
larrfs	â¤
larrhk	â†©
larrlp	â†«
larrpl	â¤¹
larrsim	â¥³
larrtl	â†¢
lat	âª«
latail	â¤™
lAtail	â¤›
late	âª­
lates	âª­ï¸€
lbarr	â¤Œ
lBarr	â¤
lbbrk	â²
lbrace	{
lbrack	[
lbrke	â¦‹
lbrksld	â¦
lbrkslu	â¦
Lcaron	Ä½
lcaron	Ä¾
Lcedil	Ä»
lcedil	Ä¼
lceil	âŒˆ
lcub	{
Lcy	Ğ›
lcy	Ğ»
ldca	â¤¶
ldquo	â€œ
ldquor	â€
ldrdhar	â¥§
ldrushar	â¥‹
ldsh	â†²
le	â‰¤
lE	â‰¦
LeftAngleBracket	âŸ¨
leftarrow	â†
Leftarrow	â‡
LeftArrowBar	â‡¤
LeftArrowRightArrow	â‡†
leftarrowtail	â†¢
LeftCeiling	âŒˆ
LeftDoubleBracket	âŸ¦
LeftDownTeeVector	â¥¡
LeftDownVector	â‡ƒ
LeftDownVectorBar	â¥™
LeftFloor	âŒŠ
leftharpoondown	â†½
leftharpoonup	â†¼
leftleftarrows	â‡‡
leftrightarrow	â†”
Leftrightarrow	â‡”
leftrightarrows	â‡†
leftrightharpoons	â‡‹
leftrightsquigarrow	â†­
LeftRightVector	â¥
LeftTee	âŠ£
LeftTeeArrow	â†¤
LeftTeeVector	â¥š
leftthreetimes	â‹‹
LeftTriangle	âŠ²
LeftTriangleBar	â§
LeftTriangleEqual	âŠ´
LeftUpDownVector	â¥‘
LeftUpTeeVector	â¥ 
LeftUpVector	â†¿
LeftUpVectorBar	â¥˜
LeftVector	â†¼
LeftVectorBar	â¥’
leg	â‹š
lEg	âª‹
leq	â‰¤
leqq	â‰¦
leqslant	â©½
les	â©½
lescc	âª¨
lesdot	â©¿
lesdoto	âª
lesdotor	âªƒ
lesg	â‹šï¸€
lesges	âª“
lessapprox	âª…
lessdot	â‹–
lesseqgtr	â‹š
lesseqqgtr	âª‹
LessEqualGreater	â‹š
LessFullEqual	â‰¦
LessGreater	â‰¶
lessgtr	â‰¶
LessLess	âª¡
lesssim	â‰²
LessSlantEqual	â©½
LessTilde	â‰²
lfisht	â¥¼
lfloor	âŒŠ
Lfr	ğ”
lfr	ğ”©
lg	â‰¶
lgE	âª‘
Lgr	Î›
lgr	Î»
lHar	â¥¢
lhard	â†½
lharu	â†¼
lharul	â¥ª
lhblk	â–„
LJcy	Ğ‰
ljcy	Ñ™
ll	â‰ª
Ll	â‹˜
llarr	â‡‡
llcorner	âŒ
Lleftarrow	â‡š
llhard	â¥«
lltri	â—º
Lmidot	Ä¿
lmidot	Å€
lmoust	â°
lmoustache	â°
lnap	âª‰
lnapprox	âª‰
lnE	â‰¨
lne	âª‡
lneq	âª‡
lneqq	â‰¨
lnsim	â‹¦
loang	âŸ¬
loarr	â‡½
lobrk	âŸ¦
longleftarrow	âŸµ
Longleftarrow	âŸ¸
longleftrightarrow	âŸ·
Longleftrightarrow	âŸº
longmapsto	âŸ¼
longrightarrow	âŸ¶
Longrightarrow	âŸ¹
looparrowleft	â†«
looparrowright	â†¬
lopar	â¦…
Lopf	ğ•ƒ
lopf	ğ•
loplus	â¨­
lotimes	â¨´
lowast	âˆ—
lowbar	_
LowerLeftArrow	â†™
LowerRightArrow	â†˜
loz	â—Š
lozenge	â—Š
lozf	â§«
lpar	(
lparlt	â¦“
lrarr	â‡†
lrcorner	âŒŸ
lrhar	â‡‹
lrhard	â¥­
lrm	â€
lrtri	âŠ¿
lsaquo	â€¹
Lscr	â„’
lscr	ğ“
lsh	â†°
lsim	â‰²
lsime	âª
lsimg	âª
lsqb	[
lsquo	â€˜
lsquor	â€š
Lstrok	Å
lstrok	Å‚
lt	<
Lt	â‰ª
ltcc	âª¦
ltcir	â©¹
ltdot	â‹–
lthree	â‹‹
ltimes	â‹‰
ltlarr	â¥¶
ltquest	â©»
ltri	â—ƒ
ltrie	âŠ´
ltrif	â—‚
ltrPar	â¦–
lurdshar	â¥Š
luruhar	â¥¦
lvertneqq	â‰¨ï¸€
lvnE	â‰¨ï¸€
macr	Â¯
male	â™‚
malt	âœ 
maltese	âœ 
map	â†¦
Map	â¤…
mapsto	â†¦
mapstodown	â†§
mapstoleft	â†¤
mapstoup	â†¥
marker	â–®
mcomma	â¨©
Mcy	Ğœ
mcy	Ğ¼
mdash	â€”
mDDot	âˆº
measuredangle	âˆ¡
MediumSpace	âŸ
Mellintrf	â„³
Mfr	ğ”
mfr	ğ”ª
Mgr	Îœ
mgr	Î¼
mho	â„§
micro	Âµ
mid	âˆ£
midast	*
midcir	â«°
middot	Â·
minus	âˆ’
minusb	âŠŸ
minusd	âˆ¸
minusdu	â¨ª
MinusPlus	âˆ“
mlcp	â«›
mldr	â€¦
mnplus	âˆ“
models	âŠ§
Mopf	ğ•„
mopf	ğ•
mp	âˆ“
Mscr	â„³
mscr	ğ“‚
mstpos	âˆ¾
Mu	Îœ
mu	Î¼
multimap	âŠ¸
mumap	âŠ¸
nabla	âˆ‡
Nacute	Åƒ
nacute	Å„
nang	âˆ âƒ’
nap	â‰‰
napE	â©°Ì¸
napid	â‰‹Ì¸
napos	Å‰
napprox	â‰‰
natur	â™®
natural	â™®
naturals	â„•
nbsp	Â 
nbump	â‰Ì¸
nbumpe	â‰Ì¸
ncap	â©ƒ
Ncaron	Å‡
ncaron	Åˆ
Ncedil	Å…
ncedil	Å†
ncong	â‰‡
ncongdot	â©­Ì¸
ncup	â©‚
Ncy	Ğ
ncy	Ğ½
ndash	â€“
ne	â‰ 
nearhk	â¤¤
nearr	â†—
neArr	â‡—
nearrow	â†—
nedot	â‰Ì¸
NegativeMediumSpace	â€‹
NegativeThickSpace	â€‹
NegativeThinSpace	â€‹
NegativeVeryThinSpace	â€‹
nequiv	â‰¢
nesear	â¤¨
nesim	â‰‚Ì¸
NestedGreaterGreater	â‰«
NestedLessLess	â‰ª
NewLine	

nexist	âˆ„
nexists	âˆ„
Nfr	ğ”‘
nfr	ğ”«
ngE	â‰§Ì¸
nge	â‰±
ngeq	â‰±
ngeqq	â‰§Ì¸
ngeqslant	â©¾Ì¸
nges	â©¾Ì¸
nGg	â‹™Ì¸
Ngr	Î
ngr	Î½
ngsim	â‰µ
nGt	â‰«âƒ’
ngt	â‰¯
ngtr	â‰¯
nGtv	â‰«Ì¸
nharr	â†®
nhArr	â‡
nhpar	â«²
ni	âˆ‹
nis	â‹¼
nisd	â‹º
niv	âˆ‹
NJcy	ĞŠ
njcy	Ñš
nlarr	â†š
nlArr	â‡
nldr	â€¥
nlE	â‰¦Ì¸
nle	â‰°
nleftarrow	â†š
nLeftarrow	â‡
nleftrightarrow	â†®
nLeftrightarrow	â‡
nleq	â‰°
nleqq	â‰¦Ì¸
nleqslant	â©½Ì¸
nles	â©½Ì¸
nless	â‰®
nLl	â‹˜Ì¸
nlsim	â‰´
nLt	â‰ªâƒ’
nlt	â‰®
nltri	â‹ª
nltrie	â‹¬
nLtv	â‰ªÌ¸
nmid	âˆ¤
NoBreak	â 
NonBreakingSpace	Â 
Nopf	â„•
nopf	ğ•Ÿ
not	Â¬
Not	â«¬
NotCongruent	â‰¢
NotCupCap	â‰­
NotDoubleVerticalBar	âˆ¦
NotElement	âˆ‰
NotEqual	â‰ 
NotEqualTilde	â‰‚Ì¸
NotExists	âˆ„
NotGreater	â‰¯
NotGreaterEqual	â‰±
NotGreaterFullEqual	â‰¦Ì¸
NotGreaterGreater	â‰«Ì¸
NotGreaterLess	â‰¹
NotGreaterSlantEqual	â©¾Ì¸
NotGreaterTilde	â‰µ
NotHumpDownHump	â‰Ì¸
NotHumpEqual	â‰Ì¸
notin	âˆ‰
notindot	â‹µÌ¸
notinE	â‹¹Ì¸
notinva	âˆ‰
notinvb	â‹·
notinvc	â‹¶
NotLeftTriangle	â‹ª
NotLeftTriangleBar	â§Ì¸
NotLeftTriangleEqual	â‹¬
NotLess	â‰®
NotLessEqual	â‰°
NotLessGreater	â‰¸
NotLessLess	â‰ªÌ¸
NotLessSlantEqual	â©½Ì¸
NotLessTilde	â‰´
NotNestedGreaterGreater	âª¢Ì¸
NotNestedLessLess	âª¡Ì¸
notni	âˆŒ
notniva	âˆŒ
notnivb	â‹¾
notnivc	â‹½
NotPrecedes	âŠ€
NotPrecedesEqual	âª¯Ì¸
NotPrecedesSlantEqual	â‹ 
NotReverseElement	âˆŒ
NotRightTriangle	â‹«
NotRightTriangleBar	â§Ì¸
NotRightTriangleEqual	â‹­
NotSquareSubset	âŠÌ¸
NotSquareSubsetEqual	â‹¢
NotSquareSuperset	âŠÌ¸
NotSquareSupersetEqual	â‹£
NotSubset	âŠ‚âƒ’
NotSubsetEqual	âŠˆ
NotSucceeds	âŠ
NotSucceedsEqual	âª°Ì¸
NotSucceedsSlantEqual	â‹¡
NotSucceedsTilde	â‰¿Ì¸
NotSuperset	âŠƒâƒ’
NotSupersetEqual	âŠ‰
NotTilde	â‰
NotTildeEqual	â‰„
NotTildeFullEqual	â‰‡
NotTildeTilde	â‰‰
NotVerticalBar	âˆ¤
npar	âˆ¦
nparallel	âˆ¦
nparsl	â«½âƒ¥
npart	âˆ‚Ì¸
npolint	â¨”
npr	âŠ€
nprcue	â‹ 
npre	âª¯Ì¸
nprec	âŠ€
npreceq	âª¯Ì¸
nrarr	â†›
nrArr	â‡
nrarrc	â¤³Ì¸
nrarrw	â†Ì¸
nrightarrow	â†›
nRightarrow	â‡
nrtri	â‹«
nrtrie	â‹­
nsc	âŠ
nsccue	â‹¡
nsce	âª°Ì¸
Nscr	ğ’©
nscr	ğ“ƒ
nshortmid	âˆ¤
nshortparallel	âˆ¦
nsim	â‰
nsime	â‰„
nsimeq	â‰„
nsmid	âˆ¤
nspar	âˆ¦
nsqsube	â‹¢
nsqsupe	â‹£
nsub	âŠ„
nsube	âŠˆ
nsubE	â«…Ì¸
nsubset	âŠ‚âƒ’
nsubseteq	âŠˆ
nsubseteqq	â«…Ì¸
nsucc	âŠ
nsucceq	âª°Ì¸
nsup	âŠ…
nsupe	âŠ‰
nsupE	â«†Ì¸
nsupset	âŠƒâƒ’
nsupseteq	âŠ‰
nsupseteqq	â«†Ì¸
ntgl	â‰¹
Ntilde	Ã‘
ntilde	Ã±
ntlg	â‰¸
ntriangleleft	â‹ª
ntrianglelefteq	â‹¬
ntriangleright	â‹«
ntrianglerighteq	â‹­
Nu	Î
nu	Î½
num	#
numero	â„–
numsp	â€‡
nvap	â‰âƒ’
nvdash	âŠ¬
nvDash	âŠ­
nVdash	âŠ®
nVDash	âŠ¯
nvge	â‰¥âƒ’
nvgt	>âƒ’
nvHarr	â¤„
nvinfin	â§
nvlArr	â¤‚
nvle	â‰¤âƒ’
nvlt	<âƒ’
nvltrie	âŠ´âƒ’
nvrArr	â¤ƒ
nvrtrie	âŠµâƒ’
nvsim	âˆ¼âƒ’
nwarhk	â¤£
nwarr	â†–
nwArr	â‡–
nwarrow	â†–
nwnear	â¤§
Oacgr	ÎŒ
oacgr	ÏŒ
Oacute	Ã“
oacute	Ã³
oast	âŠ›
ocir	âŠš
Ocirc	Ã”
ocirc	Ã´
Ocy	Ğ
ocy	Ğ¾
odash	âŠ
Odblac	Å
odblac	Å‘
odiv	â¨¸
odot	âŠ™
odsold	â¦¼
OElig	Å’
oelig	Å“
ofcir	â¦¿
Ofr	ğ”’
ofr	ğ”¬
ogon	Ë›
Ogr	ÎŸ
ogr	Î¿
Ograve	Ã’
ograve	Ã²
ogt	â§
OHacgr	Î
ohacgr	Ï
ohbar	â¦µ
OHgr	Î©
ohgr	Ï‰
ohm	â„¦
oint	âˆ®
olarr	â†º
olcir	â¦¾
olcross	â¦»
oline	â€¾
olt	â§€
Omacr	ÅŒ
omacr	Å
Omega	Î©
omega	Ï‰
Omicron	ÎŸ
omicron	Î¿
omid	â¦¶
ominus	âŠ–
Oopf	ğ•†
oopf	ğ• 
opar	â¦·
OpenCurlyDoubleQuote	â€œ
OpenCurlyQuote	â€˜
operp	â¦¹
oplus	âŠ•
or	âˆ¨
Or	â©”
orarr	â†»
ord	â©
order	â„´
orderof	â„´
ordf	Âª
ordm	Âº
origof	âŠ¶
oror	â©–
orslope	â©—
orv	â©›
oS	â“ˆ
oscr	â„´
Oscr	ğ’ª
Oslash	Ã˜
oslash	Ã¸
osol	âŠ˜
Otilde	Ã•
otilde	Ãµ
otimes	âŠ—
Otimes	â¨·
otimesas	â¨¶
Ouml	Ã–
ouml	Ã¶
ovbar	âŒ½
OverBar	Â¯
OverBrace	â
OverBracket	â´
OverParenthesis	âœ
par	âˆ¥
para	Â¶
parallel	âˆ¥
parsim	â«³
parsl	â«½
part	âˆ‚
PartialD	âˆ‚
Pcy	ĞŸ
pcy	Ğ¿
percnt	%
period	.
permil	â€°
perp	âŠ¥
pertenk	â€±
Pfr	ğ”“
pfr	ğ”­
Pgr	Î 
pgr	Ï€
PHgr	Î¦
phgr	Ï†
Phi	Î¦
phi	Ï†
phiv	Ï†
phmmat	â„³
phone	â˜
Pi	Î 
pi	Ï€
pitchfork	â‹”
piv	Ï–
planck	â„
planckh	â„
plankv	â„
plus	+
plusacir	â¨£
plusb	âŠ
pluscir	â¨¢
plusdo	âˆ”
plusdu	â¨¥
pluse	â©²
PlusMinus	Â±
plusmn	Â±
plussim	â¨¦
plustwo	â¨§
pm	Â±
Poincareplane	â„Œ
pointint	â¨•
Popf	â„™
popf	ğ•¡
pound	Â£
pr	â‰º
Pr	âª»
prap	âª·
prcue	â‰¼
pre	âª¯
prE	âª³
prec	â‰º
precapprox	âª·
preccurlyeq	â‰¼
Precedes	â‰º
PrecedesEqual	âª¯
PrecedesSlantEqual	â‰¼
PrecedesTilde	â‰¾
preceq	âª¯
precnapprox	âª¹
precneqq	âªµ
precnsim	â‹¨
precsim	â‰¾
prime	â€²
Prime	â€³
primes	â„™
prnap	âª¹
prnE	âªµ
prnsim	â‹¨
prod	âˆ
Product	âˆ
profalar	âŒ®
profline	âŒ’
profsurf	âŒ“
prop	âˆ
Proportion	âˆ·
Proportional	âˆ
propto	âˆ
prsim	â‰¾
prurel	âŠ°
Pscr	ğ’«
pscr	ğ“…
PSgr	Î¨
psgr	Ïˆ
Psi	Î¨
psi	Ïˆ
puncsp	â€ˆ
Qfr	ğ””
qfr	ğ”®
qint	â¨Œ
Qopf	â„š
qopf	ğ•¢
qprime	â—
Qscr	ğ’¬
qscr	ğ“†
quaternions	â„
quatint	â¨–
quest	?
questeq	â‰Ÿ
quot	"
rAarr	â‡›
race	â§š
Racute	Å”
racute	Å•
radic	âˆš
raemptyv	â¦³
rang	âŸ©
Rang	âŸ«
rangd	â¦’
range	â¦¥
rangle	âŸ©
raquo	Â»
rarr	â†’
Rarr	â† 
rArr	â‡’
rarrap	â¥µ
rarrb	â‡¥
rarrbfs	â¤ 
rarrc	â¤³
rarrfs	â¤
rarrhk	â†ª
rarrlp	â†¬
rarrpl	â¥…
rarrsim	â¥´
rarrtl	â†£
Rarrtl	â¤–
rarrw	â†
ratail	â¤š
rAtail	â¤œ
ratio	âˆ¶
rationals	â„š
rbarr	â¤
rBarr	â¤
RBarr	â¤
rbbrk	â³
rbrace	}
rbrack	]
rbrke	â¦Œ
rbrksld	â¦
rbrkslu	â¦
Rcaron	Å˜
rcaron	Å™
Rcedil	Å–
rcedil	Å—
rceil	âŒ‰
rcub	}
Rcy	Ğ 
rcy	Ñ€
rdca	â¤·
rdldhar	â¥©
rdquo	â€
rdquor	â€
rdsh	â†³
Re	â„œ
real	â„œ
realine	â„›
realpart	â„œ
reals	â„
rect	â–­
reg	Â®
ReverseElement	âˆ‹
ReverseEquilibrium	â‡‹
ReverseUpEquilibrium	â¥¯
rfisht	â¥½
rfloor	âŒ‹
Rfr	â„œ
rfr	ğ”¯
Rgr	Î¡
rgr	Ï
rHar	â¥¤
rhard	â‡
rharu	â‡€
rharul	â¥¬
Rho	Î¡
rho	Ï
rhov	Ï±
RightAngleBracket	âŸ©
rightarrow	â†’
Rightarrow	â‡’
RightArrowBar	â‡¥
RightArrowLeftArrow	â‡„
rightarrowtail	â†£
RightCeiling	âŒ‰
RightDoubleBracket	âŸ§
RightDownTeeVector	â¥
RightDownVector	â‡‚
RightDownVectorBar	â¥•
RightFloor	âŒ‹
rightharpoondown	â‡
rightharpoonup	â‡€
rightleftarrows	â‡„
rightleftharpoons	â‡Œ
rightrightarrows	â‡‰
rightsquigarrow	â†
RightTee	âŠ¢
RightTeeArrow	â†¦
RightTeeVector	â¥›
rightthreetimes	â‹Œ
RightTriangle	âŠ³
RightTriangleBar	â§
RightTriangleEqual	âŠµ
RightUpDownVector	â¥
RightUpTeeVector	â¥œ
RightUpVector	â†¾
RightUpVectorBar	â¥”
RightVector	â‡€
RightVectorBar	â¥“
ring	Ëš
risingdotseq	â‰“
rlarr	â‡„
rlhar	â‡Œ
rlm	â€
rmoust	â±
rmoustache	â±
rnmid	â«®
roang	âŸ­
roarr	â‡¾
robrk	âŸ§
ropar	â¦†
Ropf	â„
ropf	ğ•£
roplus	â¨®
rotimes	â¨µ
RoundImplies	â¥°
rpar	)
rpargt	â¦”
rppolint	â¨’
rrarr	â‡‰
Rrightarrow	â‡›
rsaquo	â€º
Rscr	â„›
rscr	ğ“‡
rsh	â†±
rsqb	]
rsquo	â€™
rsquor	â€™
rthree	â‹Œ
rtimes	â‹Š
rtri	â–¹
rtrie	âŠµ
rtrif	â–¸
rtriltri	â§
RuleDelayed	â§´
ruluhar	â¥¨
rx	â„
Sacute	Åš
sacute	Å›
sbquo	â€š
sc	â‰»
Sc	âª¼
scap	âª¸
Scaron	Å 
scaron	Å¡
sccue	â‰½
sce	âª°
scE	âª´
Scedil	Å
scedil	ÅŸ
Scirc	Åœ
scirc	Å
scnap	âªº
scnE	âª¶
scnsim	â‹©
scpolint	â¨“
scsim	â‰¿
Scy	Ğ¡
scy	Ñ
sdot	â‹…
sdotb	âŠ¡
sdote	â©¦
searhk	â¤¥
searr	â†˜
seArr	â‡˜
searrow	â†˜
sect	Â§
semi	;
seswar	â¤©
setminus	âˆ–
setmn	âˆ–
sext	âœ¶
sfgr	Ï‚
Sfr	ğ”–
sfr	ğ”°
sfrown	âŒ¢
Sgr	Î£
sgr	Ïƒ
sharp	â™¯
SHCHcy	Ğ©
shchcy	Ñ‰
SHcy	Ğ¨
shcy	Ñˆ
ShortDownArrow	â†“
ShortLeftArrow	â†
shortmid	âˆ£
shortparallel	âˆ¥
ShortRightArrow	â†’
ShortUpArrow	â†‘
shy	Â­
Sigma	Î£
sigma	Ïƒ
sigmaf	Ï‚
sigmav	Ï‚
sim	âˆ¼
simdot	â©ª
sime	â‰ƒ
simeq	â‰ƒ
simg	âª
simgE	âª 
siml	âª
simlE	âªŸ
simne	â‰†
simplus	â¨¤
simrarr	â¥²
slarr	â†
SmallCircle	âˆ˜
smallsetminus	âˆ–
smashp	â¨³
smeparsl	â§¤
smid	âˆ£
smile	âŒ£
smt	âªª
smte	âª¬
smtes	âª¬ï¸€
SOFTcy	Ğ¬
softcy	ÑŒ
sol	/
solb	â§„
solbar	âŒ¿
Sopf	ğ•Š
sopf	ğ•¤
spades	â™ 
spadesuit	â™ 
spar	âˆ¥
sqcap	âŠ“
sqcaps	âŠ“ï¸€
sqcup	âŠ”
sqcups	âŠ”ï¸€
Sqrt	âˆš
sqsub	âŠ
sqsube	âŠ‘
sqsubset	âŠ
sqsubseteq	âŠ‘
sqsup	âŠ
sqsupe	âŠ’
sqsupset	âŠ
sqsupseteq	âŠ’
squ	â–¡
square	â–¡
SquareIntersection	âŠ“
SquareSubset	âŠ
SquareSubsetEqual	âŠ‘
SquareSuperset	âŠ
SquareSupersetEqual	âŠ’
SquareUnion	âŠ”
squarf	â–ª
squf	â–ª
srarr	â†’
Sscr	ğ’®
sscr	ğ“ˆ
ssetmn	âˆ–
ssmile	âŒ£
sstarf	â‹†
Star	â‹†
star	â˜†
starf	â˜…
straightepsilon	Ïµ
straightphi	Ï•
strns	Â¯
sub	âŠ‚
Sub	â‹
subdot	âª½
sube	âŠ†
subE	â«…
subedot	â«ƒ
submult	â«
subne	âŠŠ
subnE	â«‹
subplus	âª¿
subrarr	â¥¹
subset	âŠ‚
Subset	â‹
subseteq	âŠ†
subseteqq	â«…
SubsetEqual	âŠ†
subsetneq	âŠŠ
subsetneqq	â«‹
subsim	â«‡
subsub	â«•
subsup	â«“
succ	â‰»
succapprox	âª¸
succcurlyeq	â‰½
Succeeds	â‰»
SucceedsEqual	âª°
SucceedsSlantEqual	â‰½
SucceedsTilde	â‰¿
succeq	âª°
succnapprox	âªº
succneqq	âª¶
succnsim	â‹©
succsim	â‰¿
SuchThat	âˆ‹
sum	âˆ‘
sung	â™ª
sup	âŠƒ
Sup	â‹‘
sup1	Â¹
sup2	Â²
sup3	Â³
supdot	âª¾
supdsub	â«˜
supe	âŠ‡
supE	â«†
supedot	â«„
Superset	âŠƒ
SupersetEqual	âŠ‡
suphsol	âŠƒ/
suphsub	â«—
suplarr	â¥»
supmult	â«‚
supne	âŠ‹
supnE	â«Œ
supplus	â«€
supset	âŠƒ
Supset	â‹‘
supseteq	âŠ‡
supseteqq	â«†
supsetneq	âŠ‹
supsetneqq	â«Œ
supsim	â«ˆ
supsub	â«”
supsup	â«–
swarhk	â¤¦
swarr	â†™
swArr	â‡™
swarrow	â†™
swnwar	â¤ª
szlig	ÃŸ
Tab		
target	âŒ–
Tau	Î¤
tau	Ï„
tbrk	â´
Tcaron	Å¤
tcaron	Å¥
Tcedil	Å¢
tcedil	Å£
Tcy	Ğ¢
tcy	Ñ‚
tdot	 âƒ›
telrec	âŒ•
Tfr	ğ”—
tfr	ğ”±
Tgr	Î¤
tgr	Ï„
there4	âˆ´
therefore	âˆ´
Theta	Î˜
theta	Î¸
thetasym	Ï‘
thetav	Ï‘
THgr	Î˜
thgr	Î¸
thickapprox	â‰ˆ
thicksim	âˆ¼
ThickSpace	â€‰â€Šâ€Š
thinsp	â€‰
ThinSpace	â€‰
thkap	â‰ˆ
thksim	âˆ¼
THORN	Ã
thorn	Ã¾
tilde	Ëœ
Tilde	âˆ¼
TildeEqual	â‰ƒ
TildeFullEqual	â‰…
TildeTilde	â‰ˆ
times	Ã—
timesb	âŠ 
timesbar	â¨±
timesd	â¨°
tint	âˆ­
toea	â¤¨
top	âŠ¤
topbot	âŒ¶
topcir	â«±
Topf	ğ•‹
topf	ğ•¥
topfork	â«š
tosa	â¤©
tprime	â€´
trade	â„¢
triangle	â–µ
triangledown	â–¿
triangleleft	â—ƒ
trianglelefteq	âŠ´
triangleq	â‰œ
triangleright	â–¹
trianglerighteq	âŠµ
tridot	â—¬
trie	â‰œ
triminus	â¨º
TripleDot	 âƒ›
triplus	â¨¹
trisb	â§
tritime	â¨»
trpezium	â¢
Tscr	ğ’¯
tscr	ğ“‰
TScy	Ğ¦
tscy	Ñ†
TSHcy	Ğ‹
tshcy	Ñ›
Tstrok	Å¦
tstrok	Å§
twixt	â‰¬
twoheadleftarrow	â†
twoheadrightarrow	â† 
Uacgr	Î
uacgr	Ï
Uacute	Ãš
uacute	Ãº
uarr	â†‘
Uarr	â†Ÿ
uArr	â‡‘
Uarrocir	â¥‰
Ubrcy	Ğ
ubrcy	Ñ
Ubreve	Å¬
ubreve	Å­
Ucirc	Ã›
ucirc	Ã»
Ucy	Ğ£
ucy	Ñƒ
udarr	â‡…
Udblac	Å°
udblac	Å±
udhar	â¥®
udiagr	Î°
Udigr	Î«
udigr	Ï‹
ufisht	â¥¾
Ufr	ğ”˜
ufr	ğ”²
Ugr	Î¥
ugr	Ï…
Ugrave	Ã™
ugrave	Ã¹
uHar	â¥£
uharl	â†¿
uharr	â†¾
uhblk	â–€
ulcorn	âŒœ
ulcorner	âŒœ
ulcrop	âŒ
ultri	â—¸
Umacr	Åª
umacr	Å«
uml	Â¨
UnderBar	 Ì²
UnderBrace	âŸ
UnderBracket	âµ
UnderParenthesis	â
Union	â‹ƒ
UnionPlus	âŠ
Uogon	Å²
uogon	Å³
Uopf	ğ•Œ
uopf	ğ•¦
uparrow	â†‘
Uparrow	â‡‘
UpArrowBar	â¤’
UpArrowDownArrow	â‡…
updownarrow	â†•
Updownarrow	â‡•
UpEquilibrium	â¥®
upharpoonleft	â†¿
upharpoonright	â†¾
uplus	âŠ
UpperLeftArrow	â†–
UpperRightArrow	â†—
upsi	Ï…
Upsi	Ï’
upsih	Ï’
Upsilon	Î¥
upsilon	Ï…
UpTee	âŠ¥
UpTeeArrow	â†¥
upuparrows	â‡ˆ
urcorn	âŒ
urcorner	âŒ
urcrop	âŒ
Uring	Å®
uring	Å¯
urtri	â—¹
Uscr	ğ’°
uscr	ğ“Š
utdot	â‹°
Utilde	Å¨
utilde	Å©
utri	â–µ
utrif	â–´
uuarr	â‡ˆ
Uuml	Ãœ
uuml	Ã¼
uwangle	â¦§
vangrt	â¦œ
varepsilon	Îµ
varkappa	Ï°
varnothing	âˆ…
varphi	Ï†
varpi	Ï–
varpropto	âˆ
varr	â†•
vArr	â‡•
varrho	Ï±
varsigma	Ï‚
varsubsetneq	âŠŠï¸€
varsubsetneqq	â«‹ï¸€
varsupsetneq	âŠ‹ï¸€
varsupsetneqq	â«Œï¸€
vartheta	Ï‘
vartriangleleft	âŠ²
vartriangleright	âŠ³
vBar	â«¨
Vbar	â««
vBarv	â«©
Vcy	Ğ’
vcy	Ğ²
vdash	âŠ¢
vDash	âŠ¨
Vdash	âŠ©
VDash	âŠ«
Vdashl	â«¦
vee	âˆ¨
Vee	â‹
veebar	âŠ»
veeeq	â‰š
vellip	â‹®
verbar	|
Verbar	â€–
vert	|
Vert	â€–
VerticalBar	âˆ£
VerticalLine	|
VerticalSeparator	â˜
VerticalTilde	â‰€
VeryThinSpace	â€Š
Vfr	ğ”™
vfr	ğ”³
vltri	âŠ²
vnsub	âŠ‚âƒ’
vnsup	âŠƒâƒ’
Vopf	ğ•
vopf	ğ•§
vprop	âˆ
vrtri	âŠ³
Vscr	ğ’±
vscr	ğ“‹
vsubne	âŠŠï¸€
vsubnE	â«‹ï¸€
vsupne	âŠ‹ï¸€
vsupnE	â«Œï¸€
Vvdash	âŠª
vzigzag	â¦š
Wcirc	Å´
wcirc	Åµ
wedbar	â©Ÿ
wedge	âˆ§
Wedge	â‹€
wedgeq	â‰™
weierp	â„˜
Wfr	ğ”š
wfr	ğ”´
Wopf	ğ•
wopf	ğ•¨
wp	â„˜
wr	â‰€
wreath	â‰€
Wscr	ğ’²
wscr	ğ“Œ
xcap	â‹‚
xcirc	â—¯
xcup	â‹ƒ
xdtri	â–½
Xfr	ğ”›
xfr	ğ”µ
Xgr	Î
xgr	Î¾
xharr	âŸ·
xhArr	âŸº
Xi	Î
xi	Î¾
xlarr	âŸµ
xlArr	âŸ¸
xmap	âŸ¼
xnis	â‹»
xodot	â¨€
Xopf	ğ•
xopf	ğ•©
xoplus	â¨
xotime	â¨‚
xrarr	âŸ¶
xrArr	âŸ¹
Xscr	ğ’³
xscr	ğ“
xsqcup	â¨†
xuplus	â¨„
xutri	â–³
xvee	â‹
xwedge	â‹€
Yacute	Ã
yacute	Ã½
YAcy	Ğ¯
yacy	Ñ
Ycirc	Å¶
ycirc	Å·
Ycy	Ğ«
ycy	Ñ‹
yen	Â¥
Yfr	ğ”œ
yfr	ğ”¶
YIcy	Ğ‡
yicy	Ñ—
Yopf	ğ•
yopf	ğ•ª
Yscr	ğ’´
yscr	ğ“
YUcy	Ğ®
yucy	Ñ
yuml	Ã¿
Yuml	Å¸
Zacute	Å¹
zacute	Åº
Zcaron	Å½
zcaron	Å¾
Zcy	Ğ—
zcy	Ğ·
Zdot	Å»
zdot	Å¼
zeetrf	â„¨
ZeroWidthSpace	â€‹
Zeta	Î–
zeta	Î¶
Zfr	â„¨
zfr	ğ”·
Zgr	Î–
zgr	Î¶
ZHcy	Ğ–
zhcy	Ğ¶
zigrarr	â‡
Zopf	â„¤
zopf	ğ•«
Zscr	ğ’µ
zscr	ğ“
zwj	â€
zwnj	â€Œ
